la	ぁ
li	ぃ
lu	ぅ
le	ぇ
lo	ぉ
lya	ゃ
lyu	ゅ
lyo	ょ
0	0
1	1
2	2
3	3
4	4
5	5
6	6
7	7
8	8
9	9
?	？
!	！
"	"
#	#
$	$
%	%
&	&
'	'
(	(
)	)
*	*
+	+
,	、
-	ー
.	。
/	/
:	:
;	;
<	<
=	=
>	>
?	？
@	@
[	「
\	\
]	」
^	^
_	_
`	`
{	{
|	|
}	}
~	~
z<	‥
z~	〜
z>	…
z/	・
z(	（
z)	）
z[	『
z]	』
z{	【
z}	】
zh	←
zj	↓
zk	↑
zl	→
z;	゛
z:	゜

a	あ
i	い
u	う
e	え
o	お
c		ん
v		っ

kn		かん
kyn	きゃん
gn		がん
gyn	ぎゃん
sn		さん
syn	しゃん

sgn	しゃん
zn		ざん
jn		じゃん
zyn	じゃん
zgn	じゃん
tn		たん
tyn	ちゃん

dn		だん
dyn	ぢゃん

nn		なん
nyn	にゃん
hn		はん
hyn	ひゃん
hgn	ひゃん
fn		ふぁん
fyn	ふゃん
bn		ばん
byn	びゃん
bgn	びゃん
pn		ぱん
pyn	ぴゃん
pgn	ぴゃん
mn		まん
myn	みゃん
yn		やん
rn		らん
ryn	りゃん
wn		わん



ks		きん
kys	きぃん
gs		ぎん
gys	ぎぃん
ss		しん
sys	しぃん

sgs	しぃん
zs		じん
js		じぃん
zys	じぃん
zgs	じぃん
ts		ちん
tys	ちぃん

ds		ぢん
dys	ぢぃん

ns		にん
nys	にぃん
hs		ひん
hys	ひぃん
hgs	ひぃん
fs		ふぃん
fys	ふぃん
bs		びん
bys	びぃん
bgs	びぃん
ps		ぴん
pys	ぴぃん
pgs	ぴぃん
ms		みん
mys	みぃん
ys		いん
rs		りん
rys	りぃん
ws		うぃん



kr		くん
kyr	きゅん
gr		ぐん
gyr	ぎゅん
sr		すん
syr	しゅん

sgr	しゅん
zr		ずん
jr		じゅん
zyr	じゅん
zgr	じゅん
tr		つん
tyr	ちゅん

dr		づん
dyr	ぢゅん

nr		ぬん
nyr	にゅん
hr		ふん
hyr	ひゅん
hgr	ひゅん
fr		ふん
fyr	ふゅん
br		ぶん
byr	びゅん
bgr	びゅん
pr		ぷん
pyr	ぴゅん
pgr	ぴゅん
mr		むん
myr	みゅん
yr		ゆん
rr		るん
ryr	りゅん
wr		うん



kh		けん
kyh	きぇん
gh		げん
gyh	ぎぇん
sh		せん
syh	しぇん

sgh	しぇん
zh		ぜん
jh		じぇん
zyh	じぇん
zgh	じぇん
th		てん
tyh	ちぇん

dh		でん
dyh	ぢぇん

nh		ねん
nyh	にぇん
hh		へん
hyh	ひぇん
hgh	ひぇん
fh		ふぇん
fyh	ふぇん
bh		べん
byh	びぇん
bgh	びぇん
ph		ぺん
pyh	ぴぇん
pgh	ぴぇん
mh		めん
myh	みぇん
yh		いぇん
rh		れん
ryh	りぇん
wh		うぇん



kt		こん
kyt	きょん
gt		ごん
gyt	ぎょん
st		そん
syt	しょん

sgt	しょん
zt		ぞん
jt		じょん
zyt	じょん
zgt	じょん
tt		とん
tyt	ちょん

dt		どん
dyt	ぢょん

nt		のん
nyt	にょん
ht		ほん
hyt	ひょん
hgt	ひょん
ft		ふぉん
fyt	ふょん
bt		ぼん
byt	びょん
bgt	びょん
pt		ぽん
pyt	ぴょん
pgt	ぴょん
mt		もん
myt	みょん
yt		よん
rt		ろん
ryt	りょん
wt		をん



kc		こう
kyc	きょう
gc		ごう
gyc	ぎょう
sc		そう
syc	しょう

sgc	しょう
zc		ぞう
jc		じょう
zyc	じょう
zgc	じょう
tc		とう
tyc	ちょう

dc		どう
dyc	ぢょう

nc		のう
nyc	にょう
hc		ほう
hyc	ひょう
hgc	ひょう
fc		ふぉう
fyc	ふょう
bc		ぼう
byc	びょう
bgc	びょう
pc		ぽう
pyc	ぴょう
pgc	ぴょう
mc		もう
myc	みょう
yc		よう
rc		ろう
ryc	りょう
wc		をう



k,		かい
ky,	きゃい
g,		がい
gy,	ぎゃい
s,		さい
sy,	しゃい

sg,	しゃい
z,		ざい
j,		じゃい
zy,	じゃい
zg,	じゃい
t,		たい
ty,	ちゃい

d,		だい
dy,	ぢゃい

n,		ない
ny,	にゃい
h,		はい
hy,	ひゃい
hg,	ひゃい
f,		ふぁい
fy,	ふゃい
b,		ばい
by,	びゃい
bg,	びゃい
p,		ぱい
py,	ぴゃい
pg,	ぴゃい
m,		まい
my,	みゃい
y,		やい
r,		らい
ry,	りゃい
w,		わい



kv		けい
kyv	きぇい
gv		げい
gyv	ぎぇい
sv		せい
syv	しぇい

sgv	しぇい
zv		ぜい
jv		じぇい
zyv	じぇい
zgv	じぇい
tv		てい
tyv	ちぇい

dv		でい
dyv	ぢぇい

nv		ねい
nyv	にぇい
hv		へい
hyv	ひぇい
hgv	ひぇい
fv		ふぇい
fyv	ふぇい
bv		べい
byv	びぇい
bgv	びぇい
pv		ぺい
pyv	ぴぇい
pgv	ぴぇい
mv		めい
myv	みぇい
yv		いぇい
rv		れい
ryv	りぇい
wv		うぇい



kl		くう
kyl	きゅう
gl		ぐう
gyl	ぎゅう
sl		すう
syl	しゅう

sgl	しゅう
zl		ずう
jl		じゅう
zyl	じゅう
zgl	じゅう
tl		つう
tyl	ちゅう

dl		づう
dyl	ぢゅう

nl		ぬう
nyl	にゅう
hl		ふう
hyl	ひゅう
hgl	ひゅう
fl		ふう
fyl	ふゅう
bl		ぶう
byl	びゅう
bgl	びゅう
pl		ぷう
pyl	ぴゅう
pgl	ぴゅう
ml		むう
myl	みゅう
yl		ゆう
rl		るう
ryl	りゅう
wl		うう



k-		こい
ky-	きょい
g-		ごい
gy-	ぎょい
s-		そい
sy-	しょい

sg-	しょい
z-		ぞい
j-		じょい
zy-	じょい
zg-	じょい
t-		とい
ty-	ちょい

d-		どい
dy-	ぢょい

n-		のい
ny-	にょい
h-		ほい
hy-	ひょい
hg-	ひょい
f-		ふぉい
fy-	ふょい
b-		ぼい
by-	びょい
bg-	びょい
p-		ぽい
py-	ぴょい
pg-	ぴょい
m-		もい
my-	みょい
y-		よい
r-		ろい
ry-	りょい
w-		をい



ka	か
ki	き
ku	く
ke	け
ko	こ
kya	きゃ
kyi	きぃ
kyu	きゅ
kye	きぇ
kyo	きょ
ga	が
gi	ぎ
gu	ぐ
ge	げ
go	ご
gya	ぎゃ
gyi	ぎぃ
gyu	ぎゅ
gye	ぎぇ
gyo	ぎょ
sa	さ
si	し
su	す
se	せ
so	そ
sya	しゃ
syi	しぃ
syu	しゅ
sye	しぇ
syo	しょ
せんa	しゃ
せんi	しぃ
せんu	しゅ
せんe	しぇ
せんo	しょ
sga	しゃ
sgi	しぃ
sgu	しゅ
sge	しぇ
sgo	しょ
za	ざ
zi	じ
zu	ず
ze	ぜ
zo	ぞ
ja	じゃ
ji	じぃ
ju	じゅ
je	じぇ
jo	じょ
zya	じゃ
zyi	じぃ
zyu	じゅ
zye	じぇ
zyo	じょ
zga	じゃ
zgi	じぃ
zgu	じゅ
zge	じぇ
zgo	じょ
ta	た
ti	ち
tu	つ
te	て
to	と
tya	ちゃ
tyi	ちぃ
tyu	ちゅ
tye	ちぇ
tyo	ちょ
てんa	てゃ
てんi	てぃ
てんu	てゅ
てんe	てぇ
てんo	てょ
da	だ
di	ぢ
du	づ
de	で
do	ど
dya	ぢゃ
dyi	ぢぃ
dyu	ぢゅ
dye	ぢぇ
dyo	ぢょ
でんa	でゃ
でんi	でぃ
でんu	でゅ
でんe	でぇ
でんo	でょ
na	な
ni	に
nu	ぬ
ne	ね
no	の
nya	にゃ
nyi	にぃ
nyu	にゅ
nye	にぇ
nyo	にょ
ha	は
hi	ひ
hu	ふ
he	へ
ho	ほ
hya	ひゃ
hyi	ひぃ
hyu	ひゅ
hye	ひぇ
hyo	ひょ
hga	ひゃ
hgi	ひぃ
hgu	ひゅ
hge	ひぇ
hgo	ひょ
fa	ふぁ
fi	ふぃ
fu	ふ
fe	ふぇ
fo	ふぉ
fya	ふゃ
fyi	ふぃ
fyu	ふゅ
fye	ふぇ
fyo	ふょ
ba	ば
bi	び
bu	ぶ
be	べ
bo	ぼ
bya	びゃ
byi	びぃ
byu	びゅ
bye	びぇ
byo	びょ
bga	びゃ
bgi	びぃ
bgu	びゅ
bge	びぇ
bgo	びょ
pa	ぱ
pi	ぴ
pu	ぷ
pe	ぺ
po	ぽ
pya	ぴゃ
pyi	ぴぃ
pyu	ぴゅ
pye	ぴぇ
pyo	ぴょ
pga	ぴゃ
pgi	ぴぃ
pgu	ぴゅ
pge	ぴぇ
pgo	ぴょ
ma	ま
mi	み
mu	む
me	め
mo	も
mya	みゃ
myi	みぃ
myu	みゅ
mye	みぇ
myo	みょ
ya	や
yi	い
yu	ゆ
ye	いぇ
yo	よ
ra	ら
ri	り
ru	る
re	れ
ro	ろ
rya	りゃ
ryi	りぃ
ryu	りゅ
rye	りぇ
ryo	りょ
wa	わ
wi	うぃ
wu	う
we	うぇ
wo	を
うぇんa	うぁ
うぇんi	うぃ
うぇんu	う
うぇんe	うぇ
うぇんo	うぉ
っa	ゔぁ
っi	ゔぃ
っu	ゔ
っe	ゔぇ
っo	ゔぉ

